111111
100001
101C01
10P001
11111E