111111111111111111111111
110C10000000000C00000C01
101E11010010000010100101
101011001010101000100101
1P0CC0000C00C00000000001
111111111111111111111111